9 20
LLDULRRRLRRLRURLLUDD
RLULLLULDLLLULULRDLR
URRUURLULUDRULDUUUDD
RRDDUUUDRRURLDLRUDUU
LRDRRUUDUDRLDRDDUURU
UUUDRULURURRULRLLLLD
LLLULDURDDLUUUUDLRLU
DRRUUUDUUULLUUUDDRLL
RUULDRRLRDDLRRLLDUUL